{
  "cols": 42,
  "rows": 30,
  "tileset": "outdoors",
  "tilesheet": "midoria",
  "tiles": [4, 2, 0, 0, 0, 0, 2, 1, 1, 1, 1, 0, 0, 3, 2, 2, 3, 0, 0, 0, 0, 2, 2, 3, 3,
            4, 2, 0, 0, 0, 0, 1, 1, 1, 1, 0, 0, 0, 2, 3, 2, 2, 0, 0, 0, 0, 2, 3, 2, 2,
            4, 0, 0, 0, 0, 1, 1, 1, 1, 2, 0, 0, 0, 2, 0, 0, 0, 0, 0, 0, 0, 0, 0, 0, 2,
            0, 0, 0, 0, 1, 1, 1, 1, 0, 0, 0, 0, 0, 0, 0, 0, 0, 0, 2, 0, 0, 0, 0, 3, 2,
            0, 0, 0, 0, 1, 1, 1, 0, 0, 0, 0, 0, 0, 3, 2, 0, 0, 0, 0, 3, 0, 0, 0, 2, 2,
            0, 0, 0, 0, 1, 1, 1, 0, 0, 0, 0, 0, 0, 0, 0, 0, 2, 0, 0, 2, 0, 0, 0, 0, 0,
            0, 0, 2, 0, 0, 1, 1, 0, 0, 0, 2, 2, 0, 0, 0, 0, 3, 0, 0, 0, 0, 0, 0, 2, 3,
            0, 3, 2, 0, 0, 1, 1, 2, 0, 0, 3, 2, 0, 0, 0, 0, 0, 2, 0, 0, 2, 2, 0, 3, 3,
            0, 2, 0, 0, 1, 1, 1, 2, 0, 0, 0, 0, 0, 2, 3, 0, 0, 0, 2, 3, 0, 0, 0, 0, 3,
            0, 0, 0, 0, 1, 1, 1, 0, 0, 0, 0, 0, 0, 2, 2, 0, 0, 0, 2, 0, 0, 0, 0, 0, 3,
            0, 0, 0 ,0, 1, 1, 1, 0, 0, 0, 0, 0, 0, 2, 0, 0, 0, 0, 0, 0, 0, 0, 0, 2, 0,
            0, 0, 2, 1, 1, 1, 0, 0, 0, 0, 0, 0, 0, 0, 0, 0, 0, 0, 3, 2, 0, 0, 0, 3, 0,
            0, 2, 1, 1, 1, 0, 0, 0, 0, 2, 0, 0, 0, 0, 2, 0, 0, 2, 2, 2, 2, 0, 0, 2, 0,
            0, 0, 1, 1, 1, 0, 0, 0, 2, 2, 0, 0, 3, 2, 0, 0, 0, 0, 2, 2, 3, 0, 0, 0, 0,
            2, 0, 1, 1, 1, 0, 0, 0, 3, 2, 0, 0, 2, 2, 0, 0, 0, 2, 0, 0, 0, 0, 0, 0, 0,
            2, 0, 1, 1, 1, 0, 0, 0, 0, 0, 0, 0, 2, 0, 0, 0, 2, 3, 2, 0, 0, 2, 3, 0, 0],

  "idles": [2, 0, 0, 0, 0, 0, 0, 5, 0, 1, 7, 0, 0, 0, 0, 0, 0, 0, 0, 0, 0, 0, 0, 0, 0,
            2, 0, 0, 0, 0, 0, 5, 3, 1, 7, 0, 0, 0, 0, 0, 0, 0, 0, 0, 0, 0, 0, 0, 0, 0,
            1, 0, 0, 0, 0, 5, 3, 1, 7, 0, 0, 0, 0, 0, 0, 0, 0, 0, 0, 0, 0, 0, 0, 0, 0,
            0, 0, 0, 0, 5, 3, 1, 7, 0, 0, 0, 0, 0, 0, 0, 0, 0, 0, 0, 0, 0, 0, 0, 0, 0,
            0, 0, 0, 0, 9, 0, 10, 0, 0, 0, 0, 0, 0, 0, 0, 0, 0, 0, 0, 0, 0, 0, 0, 0, 0,
            0, 0, 0, 0, 8, 2, 10, 0, 0, 0, 0, 0, 0, 0, 0, 0, 0, 0, 0, 0, 0, 0, 0, 0, 0,
            0, 0, 0, 0, 0, 9, 10, 0, 0, 0, 0, 0, 0, 0, 0, 0, 0, 0, 0, 0, 0, 0, 0, 0, 0,
            0, 0, 0, 0, 0, 9, 10, 0, 0, 0, 0, 0, 0, 0, 0, 0, 0, 0, 0, 0, 0, 0, 0, 0, 0,
            0, 0, 0, 0, 5, 3, 10, 0, 0, 0, 0, 0, 0, 0, 0, 0, 0, 0, 0, 0, 0, 0, 0, 0, 0,
            0, 0, 0, 0, 9, 0, 10, 0, 0, 0, 0, 0, 0, 0, 0, 0, 0, 0, 0, 0, 0, 0, 0, 0, 0,
            0, 0, 0 ,0, 9, 1, 7, 0, 0, 0, 0, 0, 0, 0, 0, 0, 0, 0, 0, 0, 0, 0, 0, 0, 0,
            0, 0, 0, 5, 1, 7, 0, 0, 0, 0, 0, 0, 0, 0, 0, 0, 0, 0, 0, 0, 0, 0, 0, 0, 0,
            0, 0, 5, 3, 10, 0, 0, 0, 0, 0, 0, 0, 0, 0, 0, 0, 0, 0, 0, 0, 0, 0, 0, 0, 0,
            0, 0, 9, 0, 10, 0, 0, 0, 0, 0, 0, 0, 0, 0, 0, 0, 0, 0, 0, 0, 0, 0, 0, 0, 0,
            0, 0, 9, 0, 10, 0, 0, 0, 0, 0, 0, 0, 0, 0, 0, 0, 0, 0, 0, 0, 0, 0, 0, 0, 0,
            0, 0, 9, 0, 10, 0, 0, 0, 0, 0, 0, 0, 0, 0, 0, 0, 0, 0, 0, 0, 0, 0, 0, 0, 0]
}